prefix: "&f[&aTownWars&f] "

assist-nation-attack: "&bAssist &f{NATION_ATTACKER}&b &bconquer &f{NATION_DEFENDER}&b &bby running &f/war join {DEFENDERS}&b"
assist-nation-defense: "&bAssist &f{NATION_DEFENDER}&b defend against &f{NATION_ATTACKER}&b &bby running &f/war join {DEFENDERS}&b"
assist-allied-to-both-attackers-defenders: "&cA nation war has started but you cannot join while allied to both &f{NATION_ATTACKER}&c and &f{NATION_DEFENDER}"
attackers-now-at-peace-nation-war: "&bYou are now at peace with &f{NATION_DEFENDERS}"
attackers-now-at-peace-town-war: "&bYou are now at peace with &f{DEFENDERS}"
attackers-you-tied-nation-war: "&bYou drew the war against &f{NATION_DEFENDERS}&b"
attackers-you-tied-town-war: "&bYou drew the war against &f{DEFENDERS}&b"
attackers-you-lost-nation-war: "&bYou failed to siege &f{NATION_DEFENDERS}&b"
attackers-you-lost-town-war: "&bYou failed to siege &f{DEFENDERS}&b"
attackers-you-won-nation-war: "&bYou won &f{CLAIMS}&b claims&b and have been refunded &a$&f{COST}&b for winning the nation war against &f{NATION_DEFENDER}&b"
attackers-you-won-town-war: "&bYou won &f{CLAIMS}&b claims&b and have been refunded &a$&f{COST}&b for winning the war against &f{DEFENDERS}&b"
attacking-nations-you-lost-nation-war: "&bYou lost the war helping &f{ATTACKERS}&b siege &f{DEFENDERS}&b"
attacking-nations-you-won-nation-war: "&bYou won &f{CLAIMS}&b claims&b for helping &f{NATION_ATTACKER}&b win the nation war against &f{NATION_DEFENDER}&b"
cannot-place-blocks-on-home-block: "&cYou cannot place blocks on the home block"
command-an-error-occurred: "&4An unknown error has occurred."
command-ally-of-both-attackers-and-defenders: "&cYou cannot join this war because you are allied to both &f{NATION_ATTACKER}&c and &f{NATION_DEFENDER}"
command-already-joined-war: "&cYou are already in this war!"
command-cannot-attack-allies: "&cYou cannot attack your allies"
command-cannot-attack-already-at-war: "&cYou are already at war!"
command-cannot-attack-as-neutral: "&cA neutral nation cannot go to war"
command-cannot-attack-neutral: "&cA neutral nation cannot be attacked"
command-cannot-attack-not-enough-defenders-online: "&bA defender with &f{CURRENT_PLAYERS}&b &bplayers must have at least &f{MINIMUM_ONLINE}&b &bplayers online to be attacked"
command-cannot-attack-yourself: "&cYou cannot attack yourself!"
command-cannot-find-war-to-join: "&cCannot find specified war to join"
command-cannot-join-war-in-progress: "&cYou cannot join a war that already started"
command-help: "&9War command help\n/war list - see current wars\n/war declare [town] - start a war\n/war end [town] - request to end a war peacefully\n/war surrender [town] - avoid combat and forfeit the war"
command-must-be-enemies: "&cYou must be a enemy of the defending nation"
command-must-specify-towns-because-multiple-wars: "You are in multiple wars, specify a town"
command-must-specify-war-to-end: "&cYou must specify a town"
command-must-specify-war-to-surrender: "&cYou must specify a town"
command-next-peace-request-time: "&bYou can send the next peace request in &f{TIME_LEFT}"
command-not-ally-of-defender-or-attacker: "&cYou must be a nation ally of &f{NATION_ATTACKER}&c or &f{NATION_DEFENDER}&c to join a war"
command-not-enough-balance-nation-war: "&cYou need &a$&f{COST}&c to start a nation war"
command-not-enough-balance-town-war: "&cYou need &a$&f{COST}&c to start a town war"
command-not-in-any-wars: "&cYou are not in any wars"
command-not-nation-war: "&cYou cannot join a town war"
command-not-part-of-nation: "&cYou must be in a nation"
command-not-part-of-town: "&cYou must be in a town"
command-now-at-war-with-nation: "&cYou are now at war with &f{NATION_DEFENDER}&b"
command-now-at-war-with-town: "&cYou are now at war with &f{DEFENDERS}&b"
command-no-specified-town: "&CYou must specify a town"
command-no-specified-war: "&cUnable to locate war"
command-nothing-to-confirm: "&cThere is nothing to confirm"
command-only-capital-can-attack-capital: "&cOnly a capital town can attack a capital town"
command-peace-request-sent: "&bA peace request has been sent"
command-town-not-specified: "&cUnable to locate town"
confirmation-expired: "&cYour action has expired - you only have &f{SECONDS_TO_CONFIRM} seconds&c to confirm war"
confirm-start-nation-war: "&fYou are declaring a nation war\n&bNations Attacking: &f{NATION_ATTACKERS}\n&bNation Defending: &f{NATION_DEFENDERS}\n&bTime Limit: &f{TIME_LIMIT}\n&b&bCost to start: &f{COST}\n&cConfirm with /war confirm"
confirm-start-town-war: "&fYou are declaring a town war\n&bAttackers: &f{ATTACKERS}\n&bDefenders: &f{DEFENDERS}\n&bTime Limit: &f{TIME_LIMIT}\n&bCost to start: &f{COST}\n&cConfirm with /war confirm"
confirm-join-nation-war-attackers: "&9You are joining a nation war as an attacker\n&bNations Attacking: &f{NATION_ATTACKERS}\n&bNations Defending: &f{NATION_DEFENDERS}\n&bTime Left: &f{TIME_LEFT}\n&bCost to join: &f{COST}\n&cConfirm with /war confirm"
confirm-join-nation-war-defenders: "&9You are joining a nation war as a defender\n&bNations Attacking: &f{NATION_ATTACKERS}\n&bNations Defending: &f{NATION_DEFENDERS}\n&bTime Left: &f{TIME_LEFT}\n&bCost to join: &f{COST}\n&cConfirm with /war confirm"
defenders-nation-war-was-declared: "&cYou are now at war with &f{NATION_ATTACKERS}"
defenders-town-war-was-declared: "&f{ATTACKERS}&c is now at war with you!"
defenders-now-at-peace-nation-war: "&bYou are now at peace with &f{NATION_ATTACKERS}"
defenders-now-at-peace-town-war: "&bYou are now at peace with &f{ATTACKERS}"
defenders-you-lost-nation-war: "&bYou drew the war against &f{NATION_ATTACKERS}&b"
defenders-you-lost-town-war: "&bYou drew the war against &f{ATTACKERS}&b"
defenders-you-lost-nation-war: "&bYou lost &f{CLAIMS}&b claims&b for losing the nation war against &f{NATION_ATTACKERS}&b"
defenders-you-lost-town-war: "&bYou lost &f{CLAIMS}&b claims&b for losing the war against &f{ATTACKERS}&b"
defenders-you-won-nation-war: "&bYou defended your town against &f{NATION_ATTACKERS}&b and have received &a$&f{COST}&b&b"
defenders-you-won-town-war: "&bYou defended your town against &f{ATTACKERS}&b and have received &a$&f{COST}&b&b"
defending-nations-you-lost-nation-war: "&bYou lost the war helping &f{NATION_DEFENDERS}&b defend their nation from &f{NATION_ATTACKERS}&b"
defending-nations-you-won-nation-war: "&bYou won the war helping &f{NATION_DEFENDERS}&b defend their nation from &f{NATION_ATTACKERS}&b and have received &a$&f{COST}&b&b"
deposit-error: "An error occurred while depositing funds"
nation-war-deposit: "Winning nation war"
nation-war-time-left: "&bThe nation war will end in &f{TIME_LEFT}"
nation-war-join-attackers: "Joining nation war as attackers"
nation-war-join-defenders: "Joining nation war as defenders"
nation-war-withdraw: "Starting nation war"
no-permission: "&cYou do not have permission"
not-occupying-warning: "&cYou will lose the war in &f{SECONDS_NOT_OCCUPIED_UNTIL_FAIL}&c &cif no attacking players are in &f{DEFENDERS}'s&c land"
town-capture-now-paused-in-combat: "&9{DEFENDERS}&b capture &fpaused"
town-capture-resumed-no-longer-in-combat: "&9{DEFENDERS}&b capture &fresumed"
town-wants-peace: "&a&f{TOWN}&b wants peace"
town-war-deposit: "Winning town war"
town-war-time-left: "&bThe war will end in &f{TIME_LEFT}"
town-war-join: "Joining town war"
town-war-withdraw: "Starting town war"
war-joined-as-attacker: "&f{NATION}&b &bhas joined the war to help &f{NATION_ATTACKER}&b &bconquer &f{NATION_DEFENDER}"
war-joined-as-defender: "&f{NATION}&b &bhas joined the war to help &f{NATION_DEFENDER}&b &bdefend against &f{NATION_ATTACKER}&b"
war-list-format-nation: "&bAttackers: &f{NATION_ATTACKERS}&b &bDefenders: &f{NATION_DEFENDERS}&b &bTime left: &f{TIME_LEFT}"
war-list-format-town: "&bAttackers: &f{ATTACKERS}&b &bDefenders: &f{DEFENDERS}&b &bTime left: &f{TIME_LEFT}"
war-list-header: "&bWar list"
withdraw-error: "&cAn error occurred while withdrawing funds"

attacking-nation-wants-peace: "&b{NATION_ATTACKER}&b want peace"
defending-nation-wants-peace: "&b{NATION_DEFENDER}&b want peace"
attacking-town-wants-peace: "&b{ATTACKERS}&b want peace"
defending-town-wants-peace: "&b{DEFENDERS}&b want peace"

attacking-boss-bar-war-message: "&fAttacker Lives {ATTACKER_LIVES} &a| &fDefender Lives {DEFENDER_LIVES}"
defending-boss-bar-war-message: "&fDefender Lives {DEFENDER_LIVES} &a| &fAttacker Lives {ATTACKER_LIVES}"
attacking-boss-bar-prewar-message: "Countdown to War"
defending-boss-bar-prewar-message: "Countdown to War"

global-new-town-war: "&f{ATTACKERS}&b has declared war on &f{DEFENDERS}"
global-attackers-win-town-war: "&f{ATTACKERS}&b has conquered &f{DEFENDERS}"
global-defenders-win-town-war: "&f{DEFENDERS}&b defended against &f{ATTACKERS}"
global-town-war-ends-peacefully: "&f{ATTACKERS}&b have ended the war against &f{DEFENDERS}&b peacefully"

global-new-nation-war: "&f{NATION_ATTACKER}&b has declared war on &f{NATION_DEFENDER}"
global-attackers-win-nation-war: "&f{NATION_ATTACKERS}&b has conquered &f{NATION_DEFENDERS}"
global-defenders-win-nation-war: "&f{NATION_DEFENDERS}&b defended against &f{NATION_ATTACKERS}"
global-nation-war-ends-peacefully: "&f{NATION_ATTACKERS}&b have ended the war against &f{NATION_DEFENDERS}&b peacefully"

cooldown-attackers-lose-attack-same-town: "&bYou cannot attack &f{DEFENDERS}&b again for &f{TIME}"
cooldown-attackers-lose-attack-different-town: "&bYou lost a siege and cannot attack for &f{TIME}"
cooldown-defenders-lose-attack-by-different-town: "&f{DEFENDERS}&b lost a war and cannot be attacked for &f{TIME}"

attackers-must-be-in-nation: "&cYou must be in a nation to attack"
defenders-must-be-in-nation: "&cYou cannot attack a town that has no nation"

town-war-prewar-ended: "&bThe war has begun!  Respawn points set to current location."
town-war-prewar-ended: "&bThe war has begun!  Respawn points set to current location."